wwwwwwwwwwwwwwwwwwwwwwwwww
w----x---w--A--------x---w
w----------------w-------w
wx--wwww---www-----------w
w------------------------w
w-------x----www---------w
w--------wwwwww----x-----w
w-----www-----www--------w
w-x--------------www-----w
w----------x---wwwwwwwww-w
w-----wwww----------x----w
wx--x---w--e-------------w
wwwwwwwwwwwwwwwwwwwwwwwwww