wwwwwwwwwwwwwwwwwwwwwwwwww
wx--c------A----x--------w
w---------------------x--w
w------------------------w
w-x-------------x--------w
w------------------------w
w------------------------w
w------------x--------x--w
w--x---------------------w
w------------------------w
w--------c-----------x----w
w---x------e-------------w
wwwwwwwwwwwwwwwwwwwwwwwwww