wwwwwwwwwwwwwwwwwwwwwwwwww
wx--c-----------x----A---w
w---------------------x--w
w------------------------w
w-x-------------x--------w
w---------c-------w------w
w------------------------w
w------------x--------x--w
w--x---------------------w
w------------------------w
w--------------------x---w
w---x------e-------------w
wwwwwwwwwwwwwwwwwwwwwwwwww