wwwwwwwwwwwwwwwwwwwwwwwwww
wx---------A-w-----------w
www---www----------------w
w-x----------wc-----x----w
w----wwwwww--w----wwww---w
w-----------w-------x----w
w-wwwxwwwwwwwwwwwwwwwwwwww
w---------w-----------x--w
w----w---------x---------w
w----ww--------wwwwww----w
w-wwwwww-----wwwwwwwx--x-w
w---x------e------www----w
wwwwwwwwwwwwwwwwwwwwwwwwww