wwwwwwwwwwwwwwwwwwwwwwwwww
w-----w--A--ww---x---w---w
w-------w-----w----w--w--w
wx-----x--------w--www---w
w------------------------w
w---------------w--------w
w----wwwwwwwwww--w-----x-w
w-------------w----------w
w-x-----------w----------w
w----wwwww---w----ww---x-w
w-------------w----------w
wx---------e-xw-----x----w
wwwwwwwwwwwwwwwwwwwwwwwwww