wwwwwwwwwwwwwwwwwwwwwwwwww
w-x----w--A----------w---w
w-------w----------w--w--w
wx-----x--------w--www---w
w---------------x--------w
w-------x----------------w
w----wwwwwwwwww----x---x-w
w-------------w----------w
w-x-----------w----------w
w----wwwww---w---x-w---x-w
w-------------w----------w
wx---------e--w----------w
wwwwwwwwwwwwwwwwwwwwwwwwww